2
⚪⚪⚪⚪⚪⚪⚪⚫⚫⚪⚪⚪⚪⚪⚪⚪
⚪⚪⚪⚪⚪⚪⚫⚪⚪⚫⚪⚪⚪⚪⚪⚪
⚪⚪⚪⚪⚪⚫⚪⚪⚪⚪⚫⚪⚪⚪⚪⚪
⚪⚪⚪⚪⚫⚪⚪⚫⚫⚪⚪⚫⚪⚪⚪⚪
⚪⚪⚪⚫⚪⚪⚫⚪⚪⚫⚪⚪⚫⚪⚪⚪
⚪⚪⚫⚪⚪⚫⚪⚫⚫⚪⚫⚪⚪⚫⚪⚪
⚪⚫⚪⚪⚫⚪⚫⚪⚪⚫⚪⚫⚪⚪⚫⚪
⚫⚪⚪⚫⚪⚫⚪⚪⚪⚪⚫⚪⚫⚪⚪⚫
⚪⚪⚫⚪⚫⚪⚪⚪⚪⚪⚪⚫⚪⚫⚪⚪
⚪⚫⚪⚫⚪⚪⚪⚪⚪⚪⚪⚪⚫⚪⚫⚪
⚫⚪⚫⚪⚪⚪⚪⚪⚪⚪⚪⚪⚪⚫⚪⚫
⚪⚫⚪⚪⚪⚪⚪⚪⚪⚪⚪⚪⚪⚪⚫⚪
⚫⚪⚪⚪⚪⚪⚪⚪⚪⚪⚪⚪⚪⚪⚪⚫
⚪⚪⚪⚪⚪⚪⚪⚪⚪⚪⚪⚪⚪⚪⚪⚪
