3
⚫⚫⚪⚪⚪⚪⚪⚪⚪⚪⚪⚪⚪⚪⚪⚪
⚪⚪⚫⚫⚪⚪⚪⚪⚪⚪⚪⚪⚪⚪⚪⚪
⚪⚪⚪⚪⚫⚫⚪⚪⚪⚪⚪⚪⚪⚪⚪⚪
⚪⚪⚪⚪⚪⚪⚫⚫⚪⚪⚪⚪⚪⚪⚪⚪
⚪⚪⚪⚪⚪⚪⚪⚪⚫⚫⚪⚪⚪⚪⚪⚪
⚪⚪⚪⚪⚪⚪⚪⚪⚪⚪⚫⚫⚪⚪⚪⚪
⚪⚪⚪⚪⚪⚪⚪⚪⚪⚪⚪⚪⚫⚫⚪⚪
⚪⚪⚪⚪⚪⚪⚪⚪⚪⚪⚪⚪⚪⚪⚫⚫
⚪⚪⚪⚪⚪⚪⚪⚪⚪⚪⚪⚪⚪⚪⚫⚫
⚪⚪⚪⚪⚪⚪⚪⚪⚪⚪⚪⚪⚫⚫⚪⚪
⚪⚪⚪⚪⚪⚪⚪⚪⚪⚪⚫⚫⚪⚪⚪⚪
⚪⚪⚪⚪⚪⚪⚪⚪⚫⚫⚪⚪⚪⚪⚪⚪
⚪⚪⚪⚪⚪⚪⚫⚫⚪⚪⚪⚪⚪⚪⚪⚪
⚪⚪⚪⚪⚫⚫⚪⚪⚪⚪⚪⚪⚪⚪⚪⚪
⚪⚪⚫⚫⚪⚪⚪⚪⚪⚪⚪⚪⚪⚪⚪⚪
⚫⚫⚪⚪⚪⚪⚪⚪⚪⚪⚪⚪⚪⚪⚪⚪
