2
⚪⚪⚪⚪⚪⚪⚪⚫⚪⚪⚪⚪⚪⚪⚪⚪
⚪⚪⚪⚪⚪⚪⚪⚪⚫⚪⚪⚪⚪⚪⚪⚪
⚪⚪⚪⚪⚪⚪⚫⚪⚪⚪⚪⚪⚪⚪⚪⚪
⚪⚪⚪⚪⚪⚪⚪⚪⚪⚫⚪⚪⚪⚪⚪⚪
⚪⚪⚪⚪⚪⚫⚪⚪⚪⚪⚪⚪⚪⚪⚪⚪
⚪⚪⚪⚪⚪⚪⚪⚪⚪⚪⚫⚪⚪⚪⚪⚪
⚪⚪⚪⚪⚫⚪⚪⚪⚪⚪⚪⚪⚪⚪⚪⚪
⚪⚪⚪⚪⚪⚪⚪⚪⚪⚪⚪⚫⚪⚪⚪⚪
⚪⚪⚪⚫⚪⚪⚪⚪⚪⚪⚪⚪⚪⚪⚪⚪
⚪⚪⚪⚪⚪⚪⚪⚪⚪⚪⚪⚪⚫⚪⚪⚪
⚪⚪⚫⚪⚪⚪⚪⚪⚪⚪⚪⚪⚪⚪⚪⚪
⚪⚪⚪⚪⚪⚪⚪⚪⚪⚪⚪⚪⚪⚫⚪⚪
⚪⚫⚪⚪⚪⚪⚪⚪⚪⚪⚪⚪⚪⚪⚪⚪
⚪⚪⚪⚪⚪⚪⚪⚪⚪⚪⚪⚪⚪⚪⚫⚪
⚫⚪⚪⚪⚪⚪⚪⚪⚪⚪⚪⚪⚪⚪⚪⚪
⚪⚪⚪⚪⚪⚪⚪⚪⚪⚪⚪⚪⚪⚪⚪⚫
